NO ./maps/nwe.xpm
SO ./maps/nwe.xpm
WE ./maps/nwe.xpm
EA ./maps/nwe.xpm

F 255,100,0
C 225,30,0


1111111111111111111111111
1100000000000000000000001
1000000000000000000000001
1000000000000000000000001
1000000000000000000100001
1000000001000000000000001
10000000000000001111100000001
1001000001111111000000000000001 
1000000000000000000000001
1000000000000000000000001
1000000010000000000000001
1000000000000000000000001
100000000000000N000000001
1000000000000000000000001
1000000000000000000000001
1000000000000000000000001
1111111111111111111111111