/* XPM */
static char *_88b3b0f8ad44c9d912afae6b5672be5WNB3xUxOFHah4hpO[] = {
/* columns rows colors chars-per-pixel */
"64 64 20 1 ",
"  c black",
". c #1A1A18",
"X c #3D241E",
"o c #242423",
"O c #202326",
"+ c #342C28",
"@ c #2F3738",
"# c #353734",
"$ c #49383D",
"% c #0F4C00",
"& c #495254",
"* c #435458",
"= c #625249",
"- c #5B6567",
"; c #2F8000",
": c #2DB200",
"> c #45C700",
", c #6D8084",
"< c #809EA5",
"1 c #ADBBBC",
/* pixels */
"                                                                ",
"--&-&&&. ------------------------+---&-&----------&-&&&. -------",
"&&&&&&&. -&&&&&&&&&&&&&&&&&&&&-&&+&&&&&&&&&&&&&&&&&&&&&. -&&&&&&",
"&&&&&&&. -&&&&&&&&&&&&&&&&&&&&,&&$&&&&&&&&&&&&&&&&&&&&&. -&&&&&&",
"&&$<-&&. -&$<-&&&&&&&&&&&&&&&&-&&+&&&&&&&&&&&&&&&$<-&&&. -$<-&&&",
"&&$--&&. -&$--&&&&&&&&&&&&&&&&,&&$&&&&&&&&&&&&&&&$--&&&. -$--$&&",
"&&$$&&&. -&$$&&&&&&&&&&&&&&&&&,&&$&&&&&&&&&&&&&&&$$&&&&. -$$$&&&",
"&&&&&&&. -&&&&&&&&&&&&&&&&&&&&,&&$&&&&&&&&&&&&&&&&&&&&&. -&$$&&&",
"-------+.<--------------------<--&---------------------+.<-==---",
"&&&&&&&. -&&&&&&&&&&&&&&&&&&&&,&&$&&&&&&&&&&&&&&&&&&&&&. -&$$&&&",
"-------+.<--------------------<--&---------------------+.<-==---",
"-------. <--------------------<--&---------------------. <-==---",
"-------+.<--------------------<--&---------------------+.<--=---",
"-------+.<----,11111<1<<<<<<<<----,<<<<<,<,,,,,,,------+.<-=----",
"-------+.<---,1----------------------------------------+.<--=---",
"-------+.<---1-<--------------------------------<-&----+.<-=----",
"-------..,---1$--&$$$$$$$$$&$&$&&&&&&&-&-&-----$--&----..,------",
"-------+.<---1--&.............................#---&----+.<------",
"-------..,---1--$.<*@@@@@O@OOOO.O.O............---&----..,------",
"-------+.<---1--$.*@OOOOOOOO.O.O...............,--&----+.<------",
"-------..,---<--$.@OOOOOO.O.O..................,--&----..,------",
"-------+.,---1--$.@OOO.O.O.................... ,--&----+.,------",
"-------o.,---<--$.@OO.O........................,--&----o.,------",
"-------o.,---<--$.OO.O........................ ,--&----o.,------",
"-------oo,---<--$.@OO......................... <--&----oo,------",
"-------o.,---<--$.OO.......................... ,--&----o.,------",
"-------.o,---<--$.O........................... <--&----.o,------",
"-------o.,---<--&..O.......................... <--&----o.,------",
"-------..,---<--$.O........................... <--&----..,------",
"-------..,---,--&..O.......................... <--&----..,------",
"-------.+,---<--&.O........................... <--&----.+,------",
"-------+.,---,--&............................. <--$----+.,------",
"-------.+,---,--&.O........................... 1--&----.+,------",
"-------+.,---,--&............................. <--$----+.,------",
"-------.+,---,---..:.>%:.>.%>.>;.:.%:;.%.>.... 1--$----.+,------",
"-------++,---,--&..>.%:;.%.>;.>:.:.;.>.:%:.... <--$----++,------",
"-------++,---,---............................. 1--$----+.,------",
"<<<<-<-+.,---,---..>.:%.>.%:.;.>.>............ 1--$----..,------",
"         ,---,---..%;>:.:.;:.>:%.:............ 1--$----..       ",
"         ,---,---............................  1--$----.#       ",
"o. .o....,---,---#..... .                     #<--$----... .o...",
"#. ##o.#.,---,-----,-,-,,,,,,,,,,<,<<<<<<11111<---$----.#. ##o.#",
"#. ##oo#o,---,-<--------------------------------<-$----.#. ##oo#",
"#. ##oo#.,----$--------------------------------$-$&----.#. ##oo#",
"#o.##oo#o------&&&&&&&&&&$&$&$$$$$$$$$$$$$$$$$$$$&-----.#o.##oo#",
"#. ##oo#o,--------------------------------------------- #. ##oo#",
"#o.##oo#o,---------------------------------------------.#o.##oo#",
"#o ##oo#o<--------------------------------------------- #o ##oo#",
"#o.##oo#o<<<<<<<<-<-<-<<<<<<<<<<<<<<<<<<<-<-<<<<<<-<--- #o.##oo#",
"#o.##oo#o                                               #o.##oo#",
"#..##oo#o. .o...o. .o...o. .o...o. .o...o. .o...o. .o...#..##oo#",
"#o.##oo##. ##o.##. ##o.##. ##o.##. ##o.##. ##o.##. ##o.##o.##oo#",
"o. #ooo##. ##oo##. ##oo##. ##oo##. ##oo##. ##oo##. ##oo#o. #ooo#",
"#..o#oo##. ##oo##. ##oo##. ##oo##. ##oo##. ##oo##. ##oo##..o#oo#",
"o. #oo.#o. #oo.#o. #oo.#o. #oo.#o. #oo.#o. #oo.#o. #oo.#o. #oo.#",
"o  oo. oo  oo. oo  oo. oo  oo. oo  oo. oo  oo. oo  oo. oo  oo. o",
"<<<<<<<<<,<<<<,<,<,<,<,,,,,,<,<,<,<<<<<<<<<<<<<<<<<<<<<<<,<<<<,<",
"--------&----------------&-------------&-&------&-&-----&-------",
"-&-----&---------------&&---------------&--------&-----&--------",
"&--<&------<&------<&--&---<&------<&--&---<&---&--<&------<&---",
"--$&&-----$&&-----$&&-&-&-$&&-----$&&-----$&&--&--$&&-----$&&--&",
"&-$$------$$------$$---&--$$------$$------$$--&&--$$------$$--&-",
"----------------------&-------------&---------&--------------&-&",
"$XXXXXX$X$X$$$$$$$X$X$.$.$....$.$$$$$$$$X$X$$X$X$XXXXXX$X$X$$$$$"
};
